NO ./assets/textures/basic1_NO.png
SO ./assets/textures/basic1_SO.png
WE ./assets/textures/basic1_WE.png
EA ./assets/textures/basic1_EA.png

F 220,100,0
C 225,30,20       

 11111
110001
100N01
111011
  111 