NO ./assets/textures/basic_NO.png
SO ./assets/textures/basic_SO.png
WE ./assets/textures/basic_WE.png
EA ./assets/textures/basic_EA.png

F 220,100,0
C 225,30,20       

111111
110001
100N01
111011
111111