NO ./assets/textures/wolfenstein_colorstone.png
SO ./assets/textures/wolfenstein_colorstone.png
WE ./assets/textures/wolfenstein_wood.png
EA ./assets/textures/wolfenstein_wood.png
DO ./assets/textures/door_v1.png

F 0,100,40
C 0,0,0

111111111111111111111
10100D0010000000D0001
101010101011111110001
1000101D0010000010001
11111010111D1010111D1
100000101000101000001
101111101011101111111
101000001010100000101
101011111010111110101
1010D0001010100010101
101110101010101010101
100000101010001010001
111111101011111011101
100000101000D00010001
101110101110101110111
101000100000100010101
101011111111111010101
10D0100000000000D0001
101010111011111111101
1N100D00D000000000001
111111111111111111111