	WE                            assets/textures/cube.png 
NO      assets/textures/cube.png



SO assets/textures/cube.png

F   8,12,143

	DO		assets/textures/door_v1.png

EA assets/textures/cube.png



C 47,48,226


1111111111111111111
1000000000000000001
10S0000000000000001
1000000000000000001
1001111100011111001
1001   10001   1001
1001   10001   1001
1001   10001   1001
1001111100011111001
1000000000000000001
1000000000000000001
1001111111111111001
1001           1001
1001           1001
1001           1001
1001111111111111001
1000000000000000001
1000000000000000001
1000000000000000001
1111111111111111111