NO ./assets/textures/basic_NO.png
SO ./assets/textures/basic_SO.png
WE ./assets/textures/basic_WE.png
EA ./assets/textures/basic_EA.png

C 255, 192, 203
F 128, 0, 128

 11111
110001
100N01
111011
  111 