NO ./assets/textures/wolfenstein_greystone.png
SO ./assets/textures/wolfenstein_colorstone.png
WE ./assets/textures/wolfenstein_mossy.png
F 0,100,40
C 0,0,0

EA ./assets/textures/wolfenstein_wood.png

DO ./assets/textures/door_wood.png

        1111111111111111111111111
        100D000000110000000000001
        1011000001110000000000001
        1001000000D00000000000001
111111111011000001110000000000001
1E000000D01100000111D11111D111111
11110111111111D11100000010001
1111011111111101 101010010001
11000000110101D11100000010001
10000000000000000D00000010001
100d0D00000000001101010010001
1100000111010101111101111000111
 1110111 1110101 101111010001
   11111 1111111 111111111111